20 20
100 100
14 14 14 14 14 14 14 14 14 14 14 14 14 14 14 14 14 14 14 14 
13 1 1  1  1  1  1  14  14  14  14  14  1  1  1  1  1  1  1  15  
13 1 1  1  1  1  1  1  14  14  14  1  1  1  1  1  1  1  1  15  
13 1 1  1  3  3  3  3  3  14  1  1  1  1  1  1  1  1  1  15  
13 1 1  1  2  2  2  2  3  1  1  1  1  1  1  3  3  3  1  15  
13 13 13  1  3  3  3  2  3  3  3  3  3  3  1  3  2  3  1  15  
13 13 13  13  13  13  3  2  2  2  2  2  2  3  1  3  2  3  1  15  
13 3 3  3  3  3  3  2  3  2  2  3  2  3  3  3  2  3  3  15  
13 2 2  2  2  2  2  2  3  2  2  3  2  2  2  2  2  2  2  15  
13 2 2  2  3  3  3  2  3  2  3  2  2  3  3  3  3  2  2  15 
13 3 3  2  3  2  2  2  2  2  3  3  3  3  2  2  3  2  2  15  
13 2 3  2  3  2  3  3  2  2  2  2  2  2  2  2  3  2  3  15  
13 2 2  2  3  2  3  1  3  2  2  3  3  3  3  2  3  2  2  15  
13 3 2  2  3  2  3  1  1  3  2  2  2  2  3  2  3  2  2  15 
13 3 2  2  2  2  3  1  1  1  3  3  3  2  3  2  2  2  2  15  
13 3 3  3  3  3  3  1  1  1  1  1  3  2  3  2  2  15  15  15  
13 2 2  2  2  2  2  2  2  3  3  3  3  2  3  2  2  15  15  15  
13 2 2  2  2  2  2  2  2  2  2  2  2  2  2  2  15  15 15  15 
13 2 2  2  2  2  2  2  2  3  3  3  3  3  2  2  2  15  15  15  
16 16 16 16 16 16 16 16 16 16 16 16 16 16 16 16 16 16 16 16 
